111111111
10P0E00C1
111111111
