111111111111
1E00000000C1
101001001011
101001010011
1010P1001011
111111111111
